<br /><b>Правила транслита</b><br/><br/>
а - a<br/>
б - b<br/>
в - v<br/>
г - g<br/>
д - d<br/>
е - e<br/>
ё - yo<br/>
ж - zh<br/>
з - z<br/>
и - i<br/>
й - j<br/>
к - k<br/>
л - l<br/>
м - m<br/>
н - n<br/>
о - o<br/>
п - p<br/>
р - r<br/>
с - s<br/>
т - t<br/>
у - u<br/>
ф - f<br/>
х - h<br/>
ц - c<br/>
ч - ch<br/>
ш - w<br/>
щ - sh<br/>
ъ - q<br/>
ы - y<br/>
э - x<br/>
ю - yu<br/>
я - ya<br/><br/>
А - A<br/>
Б - B<br/>
В - V<br/>
Г - G<br/>
Д - D<br/>
Е - E<br/>
Ё - YO<br/>
Ж - ZH<br/>
З - Z<br/>
И - I<br/>
й - J<br/>
К - K<br/>
Л - L<br/>
М - M<br/>
Н - N<br/>
О - O<br/>
П - P<br/>
Р - R<br/>
С - S<br/>
Т - T<br/>
У - U<br/>
Ф - F<br/>
Х - H<br/>
Ц - C<br/>
Ч - CH<br/>
Ш - W<br/>
Щ - SH<br/>
Ъ - Q<br/>
Ы - Y<br/>
Э - X<br/>
Ю - YU<br/>
Я - YA<br/>
<br />